1111111111111
1011000000011
1PC0000110101
1C011100EE101
1111111111111
